# **************************************************************************** #
#                                                                              #
#                                                         :::      ::::::::    #
#    maps2.cub                                          :+:      :+:    :+:    #
#                                                     +:+ +:+         +:+      #
#    By: ltressen <ltressen@student.42perpignan.    +#+  +:+       +#+         #
#                                                 +#+#+#+#+#+   +#+            #
#    Created: 2023/08/31 16:28:05 by jcasades          #+#    #+#              #
#    Updated: 2023/10/09 12:32:14 by ltressen         ###   ########.fr        #
#                                                                              #
# **************************************************************************** #

C 10, 150 , 60
R  2147483647 2147483647
NO      ./textures/eagle.xpm
SO ./textures/greystone.xpm
EA ./textures/red.xpm
WE ./textures/purplestone.xpm

S ./textures/tonneau.xpm
F  120, 120, 120


111111111111111111111111111111
111111111000200000000000011111
100000000000000000111000100001
110000100000000000000000001111
100001111111000000020000111111
1111111000000000W0000000000001
111100000000001100000002000011
1                            1
110000000000011110000000000011
100000000000111000000000000011
11000000000011100000000000111100
110000000001111000000000000111
111111111111111111111111111111111


        11111111111111111
	1      000011  111111
11111111100000000000000111111
      10000000000000000001
      100000000000000    1
      1                  1
      1    10000N11      1
111111111111111111111111111
1                        1111
11111111111111111111111111111
      