NO ./textures/wall.xpm
SO ./textures/eagle.xpm
WE ./textures/greystone.xpm
EA ./textures/red.xpm

C 120,120,220
F 120,120,120

1111111111111111111
1000001000000000001
1001000110000000001
1100000000000000001
1000000000000000001
1000N00000000000001
1111111111111111111
