NO ./textures/barrel_side.xpm
SO ./textures/barrel_side.xpm
WE ./textures/barrel_side.xpm
EA ./textures/barrel_side.xpm

C 90,120,220
F 120,120,120


             11111
             10B01  1111111111111
             10101  10000BBBC0001
             10101  10000000000001
111111111111110101111D111111111111
1C00000000000100001000000000000001
1B00000010000100001000000000000001
111111111D1111111D1001110011111D11
100C1B001010000000010100001000001
100111001010000000010100001100001
10000000000111111110010000100001
1111111111D100000000111111V0011
1BB001C1C100000000011BCC11111
100001D1D111D111111B000001
10000D0000000000000000000C1
111111101011111111111111111
10000100100000EB0000000000011
100001001000000000BB00000001111
1E000D001011111111111111000B001
1000010010000000000000010000001
1000B100100000B00C00000D00000C1
1111110011111111111111D10000111
    1100000000000000000000011
    11001001001001001001001
    11001001001001001001001
    11BB1BB1BC1BB1CB1CB1BB1
    11111111111111111111111
