NO ./textures/red.xpm
SO ./textures/eagle.xpm
WE ./textures/greystone.xpm
EA ./textures/purplestone.xpm

C 120,120,220
F 120,120,120

1111111111111111111
1000001000000000001
100100011000000B001
1100000000000000001
1000000000000000001
100000000000000N001
1111111111111111111
