NO ./textures/wall.xpm
SO ./textures/wall.xpm
WE ./textures/wall.xpm
EA ./textures/wall.xpm

F 220,100,0
C 225,30,0

1111111111
1000000001
1000000001
1000000001
1000000001
10000000S1
1111111111
