NO ./textures/barrel_side.xpm
SO ./textures/barrel_side.xpm
WE ./textures/barrel_side.xpm
EA ./textures/barrel_side.xpm

C 120,120,220
F 120,120,120

11111111111111111111111111111111111111111111111111111111111111111111
10000010000000000011111111111111111VC001B00D0000000000010BBB010BCB01
10010001100000010010000000000000011000011111000000000001000001000001
11000000000C000000D00000000000B001100001C00D000000000001000001000001
10000000000000000100000000000000011000011111100000000001000001000001
100000000000000N0010000000000000011000000000000000000000000000000001
111111111111111111111111111D1111111111111111111D11111111111111111111
10B110000000000D000000000000000001100000000000000000000000000000D0C1
10011000000000110011100000000C01B11000000000000000000000000000111111
1000000000111111000B100001111111111111000001B000000000000000000000B1
1111111B0011111110111000011111100D0000000001000000000000000000000001
1B00000000000C110000000000000000011111B00001BC00000000000000000000C1
111111111111111111111111111111100C11111111111111111111111111111111111
                             11111