NO ./textures/barrel_side.xpm
SO ./textures/barrel_side.xpm
WE ./textures/barrel_side.xpm
EA ./textures/barrel_side.xpm

C 120,120,220
F 120,120,120

1111111111111111111
1000001000000000001111111111111111
1001000110000001201000000000000001
1100000000000000002000000000000001
1000000000000000001000000000000001
100000000000000N001000000000000001
1111111111111111111111111111111111
