NO ./textures/wall.xpm
SO ./textures/wall.xpm
WE ./textures/wall.xpm
EA ./textures/wall.xpm

F 120,120,120
C 120,120,220

1111111111111111111
1000001000000000001
1001000110000000001
1100000000000000001
1000000000000000001
1000N00000000000001
1111111111111111111
